2NNNNNNNNNNNNNNNNNNNNNNN1
WGGGGGGGGGGGGGGGGGGGGGGGE
WGGGOOOOOOOOOOOOOOOOOGGGE
WGGGOOOGGGGGGGGGGGOOOGGGE
WGGGOGGGGGGGGGGGGGGGOGGGE
WGGGOGGGGGGGGGGGGGGGOGGGE
WGGGOGGGGGGGGGGGGGGGOGGGE
WGGGOGGGGGGGGGGGGGGGOGGGE
WGGGOGGGGGGGGGGGGGGGOGGGE
WGGGOGGGGGGGGGGGGGGGOGGGE
WGGGOGGGGGGGGGGGGGGGOGGGE
WGGGOOOGGGGGGGGGGGOOOGGGE
WGGGOOOOOOOOOOOOOOOOOGGGE
WGGGGGGGGGGGGGGGGGGGGGGGE
4SSSSSSSSSSSSSSSSSSSSSSS3