2NNNNNNNNNNNNNNNNNNNNNNN1
WGGGGGGGGGGGGGGGGGGGGGGGE
WGGGGGGGGGGGGGGGGGGGGGGGE
WGGGGGOOGGGGGGGGGOOGGGGGE
WGGGGGOGGGGGGGGGGGOGGGGGE
WGGGGGGGGGGGGGGGGGGGGGGGE
WGGGGGGGGGGGGGGGGGGGGGGGE
WGGGGGGGGGGGGGGGGGGGGGGGE
WGGGGGGGGGGGGGGGGGGGGGGGE
WGGGGGGGGGGGGGGGGGGGGGGGE
WGGGGGOGGGGGGGGGGGOGGGGGE
WGGGGGOOGGGGGGGGGOOGGGGGE
WGGGGGGGGGGGGGGGGGGGGGGGE
WGGGGGGGGGGGGGGGGGGGGGGGE
4SSSSSSSSSSSSSSSSSSSSSSS3