2NNNNNNNNNNNNNNNNNNNNNNN1
WGGGGGGGGGGPGGGGGGGGGGGGE
WGGGGGGGGGGGGGGGGGGGGGGGE
WGGGGGGGGGGGGGGGGGGGGGGGE
WGGGGGGGGGGGGGGGGGGGGGGGE
WGGGGGGGGGGGGGGGGGGGGGGGE
WGGGGGGGGGGGGGGGGGGGGGGGE
WGGGGGGGGGGGGGGGGGGGGGGGE
WGGGGGGGGGGGGGGGGGGGGGGGE
WGGGGGGGGGGGGGGGGGGGGGGGE
WGGGGGGGGGGGGGGGGGGGGGGGE
WGGGGGGGGGGGGGGGGGGGGGGGE
WGGGGGGGGGGGGGGGGGGGGGGGE
WGGGGGGGGGGXGGGGGGGGGGGGE
4SSSSSSSSSSSSSSSSSSSSSSS3