2NNNNNNNNNNNNNNNNNNNNNNN1
WGGGGGGGGGGGGGGGGGGGGGGGE
WGGGGOOOOOGGGGGGGGGGGGGGE
WGGGGOGGGGGGGGGGGGGGGGGGE
WGGGGOGGGGGGGGOGGGGGGGGGE
WGOOOOGGGGGGGGOGGGGGGGGGE
WGGGGGGGGGGGGGOGGGGGGGGGE
WGGGGGGGGGGGGGOGGGGGGGGGE
WGGGGGGGGGGGGGOOOOOOGGGGE
WGGGGGGOGGGGGGGGGGGGGGGGE
WGGGGGGOGGGGGGGGGGGGGGGGE
WGGGGGGOGGGGGGGGOOOGGGGGE
WGGGOOOOGGGGGGGGOOOGGGGGE
WGGGGGGGGGGGGGGGGGGGGGGGE
4SSSSSSSSSSSSSSSSSSSSSSS3