2NNNNNNNNNNNNNNNNNNNNNNN1
WGGGGGGGGGGGGGGGGGGGGGGGE
WGGGGGGGGGGGGGGGGGGGGGGGE
WGGGGGGGGGGGGGGGGGGGGGGGE
WGGGGGGGGGGGGGGGGGGGGGGGE
WGGGGGGGGGGGGGGGGGGGGGGGE
WGGGGGGGGGGGGGGGGGGGGGGGE
WGGGGGGGGGGGGGGGGGGGGGGGE
WGGGGGGGGGGGGGGGGGGGGGGGE
WGGGGGGGGGGGGGGGGGGGGGGGE
WGGGGGGGGGGGGGGGGGGGGGGGE
WGGGGGGGGGGGGGGGGGGGGGGGE
WGGGGGGGGGGGGGGGGGGGGGGGE
WGGGGGGGGGGGGGGGGGGGGGGGE
4SSSSSSSSSSSSSSSSSSSSSSS3