2NNNNNNNNNNNNNNNNNNNNNNN1
WGGGGGGGGGGGGGGGGGGGGGGGE
WGGGGGGGGGGGGGGGGGGGGGGGE
WGGGGGGGGGGGGGGGGGGGGGGGE
WGGGGGOOOGGGGGGOGGGGGGGGE
WGGGGGGOOGGGGGGGOGGGGGGGE
WGGGGGGGGGGGGGOGGGGGGGGGE
WGGGGGGGGGGGGGGOOGGGGGGGE
WGGGGGGGGGGGGGGOOGGGGGGGE
WGGGGGGGGGGGGGGOOGGGGGGGE
WGGGGGGGGGGGGGGGGGGGOGGGE
WGGGGGGGGGGGGGGGGGGOOGGGE
WGGGGGOOOOGGGGGGGGGGGGGGE
WGGGGGOGGGGGGGGGGGGGGGGGE
4SSSSSSSSSSSSSSSSSSSSSSS3