2NNNNNNNNNNNNNNNNNNNN1
WGGGGGGGGGXGGGGGGGGGGE
WGGGGGGGGGGGGGGGGGGGGE
WGGGGGGGGGGGGGGGGGGGGE
WGGGGGGGGGGGGGGGGGGGGE
WGGGGGGGGGGGGGGGGGGGGE
WGGGGGGGGGGGGGGGGGGGGE
WGGGGGGGGGPGGGGGGGGGGE
4SSSSSSSSSSSSSSSSSSSS3