2NNNNNNNNNNNNNNNNNNNNNNN1
WGGGGGGGGGGXGGGGGGGGGGGGE
WGGGGGGGGGGGGGGGGGGGGGGGE
WGGGGGGGGGGGGGGGGGGGGGGGE
WGGGGGGGGGGGGGGGGGGGGGGGE
WGGGGGGGGGGGGGGGGGGGGGGGE
WGGGGGGGGGGGGGGGGGGGGGGGE
WGGGGGGGGGGGGGGGGGGGGGGGE
WGGGGGGGGGGGGGGGGGGGGGGGE
WGGGGGGGGGGGGGGGGGGGGGGGE
WGGGGGGGGGGGGGGGGGGGGGGGE
WGGGGGGGGGGGGGGGGGGGGGGGE
WGGGGGGGGGGGGGGGGGGGGGGGE
WGGGGGGGGGGPGGGGGGGGGGGGE
4SSSSSSSSSSSSSSSSSSSSSSS3