2NNNNNNNNNNNNNNNNNNNNNNN1
WGGGGGGGGGGGGGGGGGGGGGGGE
WGGGGGGGGGGGGGGGGGGGGGGGE
WGGGOGOGGGGGGGGGGGGGGGGGE
WGGGOGOOOOGGGGGGGGGGGGGGE
WGGGOGGGGGGGGGGGOOOOGGGGE
WGGGOOOOOOGGGGGGGGGOGGGGE
WGGGGGGGGGGGGGGGOOOOGGGGE
WGGGGGGGGGGGGGGGGGGGGGGGE
WGGGGGGGGGGGGGOOOGGGGGGGE
WGGGGGGGGGGGGGGGOGGGGGGGE
WGGGGOOOGGGGGGGGGGGGGGGGE
WGGGGOGGGGGGGGGGGGGGGGGGE
WGGGGGGGGGGGGGGGGGGGGGGGE
4SSSSSSSSSSSSSSSSSSSSSSS3